1,1,1,1,1,1,1,1,1,1,1,1,1,1,1,1,1,1,1,1,1,1,1,1,1,1,1,1,1,1
1,9,,,,,,,,,,,,,,,,,,,,,,,,,,,,1
1,9,,,,,,,,,,,,,,,,,,,,,,,,,,,,1
1,9,,,,,,,,,,,,,,,,,,,,,3,3,,,,,,1
1,1,1,1,6,6,6,1,1,1,1,1,1,1,1,1,1,1,1,1,1,4,1,1,,,,,,1
1,,,,,,,,,,,,,,,,,,,,,,,,,3,,,,1
1,,,,,,,,,,,,,,,,,,,,,,,,,1,,,,1
1,,,,,,,,,,,,,,,,,,,,,,,,,,,,,1
1,,,,,,,,,,,,,,,,,2,,,,,,,5,,,,,1
1,1,,,3,3,3,,,,,3,3,3,,,1,1,1,1,1,1,1,1,1,1,1,1,1,1
1,1,,,1,1,1,,,,,1,1,1,,,1,1,1,1,1,1,1,1,1,1,1,1,1,1
1,1,,,,,,,,,,,,,,,1,1,1,1,1,1,1,1,1,1,1,1,1,1
1,1,,,,,,,,,,3,,,,,1,1,1,1,1,1,1,1,1,1,1,1,1,1
1,1,,,1,1,1,,,,,1,1,1,,,1,1,1,1,1,1,1,1,1,1,1,1,1,1
1,1,,,,,,,,,,,,,,,1,1,1,1,1,1,1,1,1,1,1,1,1,1
1,1,3,3,,,,,,,,,,,,,1,1,1,1,1,1,1,1,1,1,1,1,1,1
1,1,1,1,1,1,1,1,1,1,1,1,1,1,1,1,1,1,1,1,1,1,1,1,1,1,1,1,1,1
