1,1,1,1,1,1,1,1,1,1,1,1,1,1,1,1,1,1,1,1,1,1,1,1,1,1,1,1,1,1
1,9,,,,,,,,,,,,,,,,,,,0,,,,,,,,,1
1,1,1,1,6,1,1,1,1,1,1,1,1,1,4,1,1,1,,,0,,,,,,,,,1
1,,,,,,,,,,,,,,,,,5,3,,0,,,,,,,,,1
1,,,,,,,,,,,,,,,,,5,1,,0,,,,,,,,,1
1,,,,,,,,,,,,,,,2,,5,,,0,,,,,,,,,1
1,,1,,3,3,,3,,,1,1,1,1,1,1,1,1,1,1,1,,,,,,,,,1
1,,1,,1,1,,1,1,,1,1,1,1,1,1,1,1,1,1,1,,,,,,,,,1
1,,1,,,,,3,,,1,1,1,1,1,1,1,1,1,1,1,,,,,,,,,1
1,,1,,1,1,,1,1,,1,1,1,1,1,1,1,1,1,1,1,,,,,,,,,1
1,,1,3,,,,,,,1,1,1,1,1,1,1,1,1,1,1,,,,,,,,,1
1,,1,1,1,1,1,1,1,1,1,1,1,1,1,1,1,1,1,1,1,,,,,,,,,1
1,,,,,,,,,,,,,,,,,,,,,,,,,,,,,1
1,,,,,,,,,,,,,,,,,,,,,,,,,,,,,1
1,,,,,,,,,,,,,,,,,,,,,,,,,,,,,1
1,,,,,,,,,,,,,,,,,,,,,,,,,,,,,1
1,1,1,1,1,1,1,1,1,1,1,1,1,1,1,1,1,1,1,1,1,1,1,1,1,1,1,1,1,1
